//MAP CONVERTED BY dmm2tgm.py THIS HEADER COMMENT PREVENTS RECONVERSION, DO NOT REMOVE
"aa" = (
/turf/open/space/basic,
/area/space/nearstation)
"ae" = (
/obj/machinery/atmospherics/components/binary/pump{
	dir = 1;
	name = "Atmos to Loop"
	},
/turf/open/floor/plating,
/area/station/engineering/supermatter/room)
"af" = (
/obj/structure/lattice/catwalk,
/turf/open/space/basic,
/area/space/nearstation)
"am" = (
/obj/machinery/door/airlock/engineering/glass{
	name = "Space Engine Room"
	},
/obj/effect/mapping_helpers/airlock/access/all/engineering/general,
/turf/open/floor/iron/dark,
/area/station/engineering/supermatter/room)
"au" = (
/turf/closed/wall/r_wall,
/area/station/engineering/supermatter/room)
"ax" = (
/obj/effect/turf_decal/stripes/line{
	dir = 1
	},
/obj/structure/cable,
/turf/open/floor/iron,
/area/station/engineering/supermatter/room)
"aJ" = (
/obj/machinery/atmospherics/pipe/smart/manifold4w/cyan/visible,
/turf/open/floor/plating,
/area/station/engineering/supermatter/room)
"aO" = (
/obj/machinery/atmospherics/components/trinary/nuclear_reactor/preset{
	dir = 2
	},
/turf/open/floor/plating,
/area/station/engineering/supermatter/room)
"aR" = (
/obj/structure/sign/directions/ptl/directional/east,
/turf/open/floor/iron/dark,
/area/station/engineering/supermatter/room)
"aV" = (
/obj/effect/spawner/structure/window/reinforced/plasma,
/turf/open/floor/plating,
/area/station/engineering/supermatter/room)
"ba" = (
/obj/machinery/door/firedoor,
/obj/machinery/door/airlock/engineering/glass{
	name = "Space Engine Room"
	},
/obj/machinery/atmospherics/pipe/smart/manifold4w/supply/hidden/layer4,
/obj/machinery/atmospherics/pipe/smart/manifold4w/scrubbers/hidden/layer2,
/obj/effect/mapping_helpers/airlock/access/all/engineering/general,
/turf/open/floor/iron/dark,
/area/station/engineering/supermatter/room)
"by" = (
/turf/open/space/basic,
/area/station/engineering/supermatter/room)
"bP" = (
/obj/machinery/camera/emp_proof/directional/north{
	c_tag = "Singularity Engine #1"
	},
/turf/open/floor/iron/dark,
/area/station/engineering/supermatter/room)
"cb" = (
/turf/open/floor/plating,
/area/station/engineering/supermatter/room)
"cr" = (
/obj/structure/cable,
/turf/open/floor/plating,
/area/station/engineering/supermatter/room)
"cI" = (
/turf/open/floor/lowered/iron/pool,
/area/station/engineering/supermatter/room)
"do" = (
/obj/effect/turf_decal/stripes/line,
/obj/effect/spawner/structure/window/reinforced/plasma,
/turf/open/floor/iron,
/area/station/engineering/supermatter/room)
"dp" = (
/obj/effect/turf_decal/stripes/line,
/obj/machinery/atmospherics/pipe/smart/manifold4w/supply/hidden/layer4,
/turf/open/floor/iron,
/area/station/engineering/supermatter/room)
"dq" = (
/obj/machinery/door/firedoor,
/obj/machinery/door/airlock/engineering/glass{
	name = "Space Engine Room"
	},
/obj/effect/mapping_helpers/airlock/access/all/engineering/general,
/turf/open/floor/plating,
/area/station/engineering/supermatter/room)
"dR" = (
/obj/structure/sign/warning/secure_area,
/turf/closed/wall/r_wall,
/area/station/engineering/supermatter/room)
"fs" = (
/obj/machinery/atmospherics/pipe/smart/manifold4w/orange/visible,
/obj/effect/spawner/structure/window/reinforced/plasma,
/turf/open/space/basic,
/area/station/engineering/supermatter/room)
"id" = (
/obj/machinery/door/airlock/engineering/glass{
	name = "PTL Room"
	},
/obj/effect/mapping_helpers/airlock/access/all/engineering/general,
/obj/structure/cable,
/turf/open/floor/iron/dark,
/area/station/engineering/supermatter/room)
"iE" = (
/obj/structure/cable/multilayer/connected,
/turf/open/floor/plating,
/area/station/engineering/supermatter/room)
"iX" = (
/obj/machinery/atmospherics/pipe/smart/manifold4w/orange/visible,
/obj/machinery/meter,
/turf/open/floor/plating,
/area/station/engineering/supermatter/room)
"ke" = (
/obj/machinery/door/firedoor,
/obj/machinery/door/airlock/engineering/glass{
	name = "Space Engine Room"
	},
/obj/effect/mapping_helpers/airlock/access/all/engineering/general,
/obj/structure/cable,
/turf/open/floor/iron/dark,
/area/station/engineering/supermatter/room)
"lc" = (
/obj/machinery/light/directional/west,
/turf/open/floor/plating,
/area/station/engineering/supermatter/room)
"my" = (
/obj/structure/cable,
/obj/machinery/atmospherics/components/unary/thermomachine/freezer/on,
/turf/open/floor/iron/dark,
/area/station/engineering/supermatter/room)
"mD" = (
/obj/machinery/power/rad_collector,
/turf/open/floor/iron/dark,
/area/station/engineering/supermatter/room)
"nK" = (
/obj/machinery/modular_computer/console/preset/engineering,
/turf/open/floor/iron,
/area/station/engineering/supermatter/room)
"nL" = (
/obj/machinery/camera/emp_proof/directional/east{
	c_tag = "Singularity Engine #3"
	},
/turf/open/floor/iron/dark,
/area/station/engineering/supermatter/room)
"pX" = (
/obj/structure/sign/warning/no_smoking,
/turf/closed/wall/r_wall,
/area/station/engineering/supermatter/room)
"rM" = (
/obj/machinery/power/apc/auto_name/directional/south,
/obj/structure/cable,
/turf/open/floor/iron/dark,
/area/station/engineering/supermatter/room)
"sf" = (
/turf/open/floor/iron,
/area/station/engineering/supermatter/room)
"sP" = (
/obj/machinery/door/firedoor,
/obj/structure/cable,
/obj/machinery/door/airlock/engineering/glass{
	name = "Space Engine Room"
	},
/obj/effect/mapping_helpers/airlock/access/all/engineering/general,
/turf/open/floor/plating,
/area/station/engineering/supermatter/room)
"sW" = (
/obj/machinery/light/directional/west,
/turf/open/floor/iron/dark,
/area/station/engineering/supermatter/room)
"uD" = (
/obj/structure/cable/layer1,
/turf/open/floor/plating,
/area/station/engineering/supermatter/room)
"vg" = (
/obj/machinery/atmospherics/pipe/heat_exchanging/simple{
	dir = 10
	},
/obj/structure/lattice/catwalk,
/turf/open/space/basic,
/area/space/nearstation)
"vw" = (
/obj/machinery/atmospherics/pipe/smart/manifold4w/orange/visible,
/turf/open/floor/plating,
/area/station/engineering/supermatter/room)
"wt" = (
/obj/machinery/atmospherics/pipe/smart/manifold4w/cyan/visible,
/obj/machinery/meter,
/obj/structure/cable,
/turf/open/floor/plating,
/area/station/engineering/supermatter/room)
"xt" = (
/obj/machinery/atmospherics/components/unary/passive_vent{
	dir = 8
	},
/obj/structure/lattice,
/turf/open/space/basic,
/area/space/nearstation)
"yp" = (
/obj/machinery/door/firedoor,
/obj/machinery/door/airlock/engineering/glass{
	name = "Space Engine Room"
	},
/obj/effect/mapping_helpers/airlock/access/all/engineering/general,
/obj/structure/cable,
/turf/open/floor/plating,
/area/station/engineering/supermatter/room)
"zw" = (
/obj/machinery/atmospherics/pipe/heat_exchanging/simple{
	dir = 6
	},
/obj/structure/lattice/catwalk,
/turf/open/space/basic,
/area/space/nearstation)
"zR" = (
/obj/structure/cable,
/obj/machinery/door/airlock/engineering/glass{
	name = "Space Engine Room"
	},
/obj/effect/mapping_helpers/airlock/access/all/engineering/general,
/turf/open/floor/iron/dark,
/area/station/engineering/supermatter/room)
"AK" = (
/obj/machinery/atmospherics/pipe/heat_exchanging/simple,
/obj/structure/lattice/catwalk,
/turf/open/space/basic,
/area/space/nearstation)
"Bf" = (
/obj/effect/turf_decal/stripes/line{
	dir = 1
	},
/obj/effect/spawner/structure/window/reinforced/plasma,
/turf/open/floor/iron,
/area/station/engineering/supermatter/room)
"Bv" = (
/obj/machinery/power/smes/engineering,
/obj/structure/cable,
/turf/open/floor/plating,
/area/station/engineering/supermatter/room)
"BM" = (
/obj/machinery/atmospherics/pipe/smart/manifold4w/yellow/visible,
/turf/open/floor/plating,
/area/station/engineering/supermatter/room)
"Ed" = (
/obj/machinery/atmospherics/pipe/smart/manifold4w/scrubbers/hidden/layer2,
/obj/structure/cable,
/turf/open/floor/iron/dark,
/area/station/engineering/supermatter/room)
"GT" = (
/obj/machinery/atmospherics/components/trinary/filter/critical{
	dir = 8;
	filter_type = list(/datum/gas/water_vapor)
	},
/turf/open/floor/plating,
/area/station/engineering/supermatter/room)
"HJ" = (
/obj/item/fuel_rod,
/turf/open/floor/lowered/iron/pool,
/area/station/engineering/supermatter/room)
"HZ" = (
/obj/machinery/atmospherics/components/unary/thermomachine/freezer,
/turf/open/floor/plating,
/area/station/engineering/supermatter/room)
"IV" = (
/turf/template_noop,
/area/template_noop)
"Jq" = (
/obj/machinery/door/airlock/engineering/glass{
	name = "Space Engine Room"
	},
/obj/effect/mapping_helpers/airlock/access/all/engineering/general,
/obj/structure/cable,
/turf/open/floor/plating,
/area/station/engineering/supermatter/room)
"JL" = (
/obj/machinery/door/airlock/engineering/glass{
	name = "Space Engine Room"
	},
/obj/effect/mapping_helpers/airlock/access/all/engineering/general,
/turf/open/floor/plating,
/area/station/engineering/supermatter/room)
"Ke" = (
/obj/machinery/atmospherics/pipe/smart/manifold4w/cyan/visible,
/obj/structure/cable,
/turf/open/floor/plating,
/area/station/engineering/supermatter/room)
"Kw" = (
/obj/structure/lattice/catwalk,
/obj/machinery/atmospherics/components/trinary/nuclear_reactor/preset,
/turf/open/space/basic,
/area/space/nearstation)
"Lj" = (
/obj/machinery/power/terminal{
	dir = 4
	},
/obj/structure/cable,
/turf/open/floor/plating,
/area/station/engineering/supermatter/room)
"Np" = (
/obj/effect/turf_decal/stripes/line{
	dir = 1
	},
/turf/open/floor/iron,
/area/station/engineering/supermatter/room)
"OB" = (
/obj/machinery/atmospherics/pipe/heat_exchanging/simple{
	dir = 9
	},
/obj/structure/lattice/catwalk,
/turf/open/space/basic,
/area/space/nearstation)
"OD" = (
/obj/effect/turf_decal/stripes/line,
/turf/open/floor/iron,
/area/station/engineering/supermatter/room)
"Qh" = (
/obj/effect/spawner/structure/window/reinforced/plasma,
/obj/machinery/atmospherics/pipe/smart/manifold4w/supply/hidden/layer4,
/turf/open/floor/plating,
/area/station/engineering/supermatter/room)
"QH" = (
/obj/structure/sign/delamination_counter/directional/north,
/turf/open/floor/iron/dark,
/area/station/engineering/supermatter/room)
"RX" = (
/obj/machinery/atmospherics/pipe/heat_exchanging/simple{
	dir = 4
	},
/obj/structure/lattice/catwalk,
/turf/open/space/basic,
/area/space/nearstation)
"Sn" = (
/obj/machinery/atmospherics/components/unary/portables_connector/visible{
	dir = 4
	},
/obj/machinery/portable_atmospherics/canister/nitrogen,
/turf/open/floor/plating,
/area/station/engineering/supermatter/room)
"TK" = (
/obj/machinery/light/directional/west,
/obj/machinery/airalarm/directional/south,
/obj/structure/cable,
/turf/open/floor/iron/dark,
/area/station/engineering/supermatter/room)
"Ui" = (
/obj/structure/cable/layer1,
/obj/structure/cable,
/obj/machinery/atmospherics/pipe/smart/manifold4w/orange/visible,
/turf/open/floor/plating,
/area/station/engineering/supermatter/room)
"US" = (
/obj/machinery/atmospherics/components/unary/portables_connector/visible,
/obj/machinery/portable_atmospherics/canister/water_vapor,
/obj/structure/cable,
/turf/open/floor/plating,
/area/station/engineering/supermatter/room)
"Vl" = (
/obj/machinery/door/firedoor,
/obj/machinery/door/airlock/engineering/glass{
	name = "Supermatter Engine Room"
	},
/obj/effect/mapping_helpers/airlock/access/all/engineering/general,
/obj/machinery/atmospherics/pipe/smart/manifold4w/scrubbers/hidden/layer2,
/obj/structure/cable,
/turf/open/floor/plating,
/area/station/engineering/supermatter/room)
"VM" = (
/turf/open/floor/iron/dark,
/area/station/engineering/supermatter/room)
"Wd" = (
/obj/structure/cable,
/turf/open/floor/iron/dark,
/area/station/engineering/supermatter/room)
"Ym" = (
/obj/machinery/atmospherics/pipe/heat_exchanging/simple{
	dir = 5
	},
/obj/structure/lattice/catwalk,
/turf/open/space/basic,
/area/space/nearstation)
"YQ" = (
/obj/machinery/atmospherics/pipe/smart/manifold4w/scrubbers/hidden/layer2,
/obj/machinery/atmospherics/pipe/smart/manifold4w/supply/hidden/layer4,
/turf/open/floor/iron/dark,
/area/station/engineering/supermatter/room)
"ZA" = (
/obj/machinery/meter,
/obj/machinery/atmospherics/pipe/smart/manifold4w/yellow/visible,
/turf/open/floor/plating,
/area/station/engineering/supermatter/room)

(1,1,1) = {"
IV
IV
IV
IV
au
aV
Vl
aV
dR
au
aV
sP
aV
pX
dR
aV
yp
Qh
au
IV
IV
IV
IV
IV
IV
"}
(2,1,1) = {"
IV
IV
IV
IV
au
Np
Ed
OD
au
sW
VM
Wd
Wd
TK
au
Np
Wd
dp
au
IV
IV
IV
IV
IV
IV
"}
(3,1,1) = {"
IV
IV
IV
IV
aV
Np
Wd
OD
JL
VM
VM
VM
VM
Wd
Jq
ax
Wd
OD
au
IV
IV
IV
IV
IV
IV
"}
(4,1,1) = {"
IV
IV
IV
IV
aV
Np
Wd
OD
au
QH
VM
VM
VM
Wd
au
Np
VM
OD
au
IV
IV
IV
IV
IV
IV
"}
(5,1,1) = {"
au
ba
au
aV
au
Np
Wd
OD
au
bP
VM
VM
VM
rM
au
Np
VM
OD
au
IV
IV
IV
IV
IV
IV
"}
(6,1,1) = {"
VM
YQ
sW
VM
au
aV
zR
aV
au
aV
aV
aV
aV
aV
au
Bf
am
do
au
IV
IV
IV
IV
IV
IV
"}
(7,1,1) = {"
VM
VM
mD
mD
aV
Np
Wd
sf
lc
cb
cb
Sn
cb
cb
lc
sf
VM
OD
au
IV
IV
IV
IV
IV
IV
"}
(8,1,1) = {"
VM
VM
mD
mD
aV
Np
Wd
sf
cb
cb
cb
vw
vw
vw
vw
vw
vw
ae
dq
IV
IV
IV
IV
IV
IV
"}
(9,1,1) = {"
VM
VM
mD
mD
aV
Np
my
sf
cb
cb
cb
iX
cb
cb
cb
sf
VM
OD
au
IV
IV
IV
IV
IV
IV
"}
(10,1,1) = {"
nL
aR
Wd
Wd
ke
Wd
Wd
sf
cb
cb
cb
cb
cb
cb
cb
nK
VM
OD
au
IV
IV
IV
IV
IV
IV
"}
(11,1,1) = {"
au
au
id
au
au
Lj
iE
US
Ke
wt
by
aO
cb
ZA
cb
cb
cb
cb
aV
IV
IV
IV
IV
IV
IV
"}
(12,1,1) = {"
IV
IV
IV
IV
au
Bv
uD
cb
aJ
cb
cb
cb
cb
BM
HZ
cb
HJ
cI
au
IV
IV
IV
IV
IV
IV
"}
(13,1,1) = {"
IV
IV
IV
IV
au
cr
Ui
vw
GT
cb
cb
cb
cb
BM
HZ
cb
HJ
cI
au
IV
IV
IV
IV
IV
IV
"}
(14,1,1) = {"
IV
IV
IV
IV
au
cb
vw
cb
BM
BM
BM
BM
BM
BM
cb
cb
HJ
cI
au
IV
IV
IV
IV
IV
IV
"}
(15,1,1) = {"
IV
IV
IV
IV
au
au
fs
au
au
au
au
au
au
au
au
au
au
au
au
IV
IV
IV
IV
IV
IV
"}
(16,1,1) = {"
IV
IV
IV
IV
aa
aa
xt
aa
aa
aa
aa
aa
aa
aa
aa
aa
aa
aa
aa
IV
IV
IV
IV
IV
IV
"}
(17,1,1) = {"
IV
IV
IV
IV
aa
aa
aa
aa
aa
aa
aa
aa
aa
aa
aa
aa
aa
aa
aa
IV
IV
IV
IV
IV
IV
"}
(18,1,1) = {"
IV
IV
IV
IV
aa
aa
aa
aa
aa
aa
aa
aa
aa
aa
aa
aa
aa
aa
aa
IV
IV
IV
IV
IV
IV
"}
(19,1,1) = {"
IV
IV
IV
IV
aa
aa
aa
af
af
af
af
af
af
af
af
af
aa
aa
aa
IV
IV
IV
IV
IV
IV
"}
(20,1,1) = {"
IV
IV
IV
IV
aa
aa
aa
af
af
af
af
af
af
af
af
af
aa
aa
aa
IV
IV
IV
IV
IV
IV
"}
(21,1,1) = {"
IV
IV
IV
IV
aa
aa
aa
af
af
af
af
af
af
af
af
af
aa
aa
aa
IV
IV
IV
IV
IV
IV
"}
(22,1,1) = {"
IV
IV
IV
IV
aa
aa
aa
af
af
af
af
Kw
af
af
af
af
aa
aa
aa
IV
IV
IV
IV
IV
IV
"}
(23,1,1) = {"
IV
IV
IV
IV
aa
aa
aa
af
af
af
af
af
af
af
af
af
aa
aa
aa
IV
IV
IV
IV
IV
IV
"}
(24,1,1) = {"
IV
IV
IV
IV
aa
aa
aa
af
af
af
af
af
af
af
af
af
aa
aa
aa
IV
IV
IV
IV
IV
IV
"}
(25,1,1) = {"
IV
IV
IV
IV
aa
aa
aa
aa
aa
aa
aa
aa
aa
aa
aa
aa
aa
zw
Ym
IV
IV
IV
IV
IV
IV
"}
(26,1,1) = {"
IV
IV
IV
IV
aa
aa
aa
aa
aa
aa
aa
aa
aa
aa
aa
aa
aa
vg
OB
IV
IV
IV
IV
IV
IV
"}
(27,1,1) = {"
IV
IV
IV
IV
aa
aa
aa
aa
aa
aa
aa
aa
aa
aa
aa
aa
aa
RX
AK
IV
IV
IV
IV
IV
IV
"}
(28,1,1) = {"
IV
IV
IV
IV
aa
aa
aa
aa
aa
aa
aa
aa
aa
aa
aa
aa
aa
aa
aa
IV
IV
IV
IV
IV
IV
"}
(29,1,1) = {"
IV
IV
IV
IV
IV
IV
IV
IV
IV
IV
IV
IV
IV
IV
IV
IV
IV
IV
IV
IV
IV
IV
IV
IV
IV
"}
(30,1,1) = {"
IV
IV
IV
IV
IV
IV
IV
IV
IV
IV
IV
IV
IV
IV
IV
IV
IV
IV
IV
IV
IV
IV
IV
IV
IV
"}
(31,1,1) = {"
IV
IV
IV
IV
IV
IV
IV
IV
IV
IV
IV
IV
IV
IV
IV
IV
IV
IV
IV
IV
IV
IV
IV
IV
IV
"}
(32,1,1) = {"
IV
IV
IV
IV
IV
IV
IV
IV
IV
IV
IV
IV
IV
IV
IV
IV
IV
IV
IV
IV
IV
IV
IV
IV
IV
"}
(33,1,1) = {"
IV
IV
IV
IV
IV
IV
IV
IV
IV
IV
IV
IV
IV
IV
IV
IV
IV
IV
IV
IV
IV
IV
IV
IV
IV
"}
