//MAP CONVERTED BY dmm2tgm.py THIS HEADER COMMENT PREVENTS RECONVERSION, DO NOT REMOVE
"aa" = (
/turf/open/space/basic,
/area/space/nearstation)
"ae" = (
/obj/machinery/atmospherics/components/trinary/mixer/flipped,
/turf/open/floor/plating,
/area/station/engineering/supermatter/room)
"af" = (
/obj/structure/lattice/catwalk,
/turf/open/space/basic,
/area/space/nearstation)
"am" = (
/obj/machinery/door/airlock/engineering/glass{
	name = "Space Engine Room"
	},
/obj/effect/mapping_helpers/airlock/access/all/engineering/general,
/turf/open/floor/iron/dark,
/area/station/engineering/supermatter/room)
"au" = (
/turf/closed/wall/r_wall,
/area/station/engineering/supermatter/room)
"ax" = (
/obj/effect/turf_decal/stripes/line{
	dir = 1
	},
/obj/structure/cable,
/turf/open/floor/iron,
/area/station/engineering/supermatter/room)
"aI" = (
/obj/machinery/atmospherics/components/unary/portables_connector/visible{
	dir = 8
	},
/obj/machinery/portable_atmospherics/canister/healium,
/turf/open/floor/plating,
/area/station/engineering/supermatter/room)
"aJ" = (
/obj/machinery/atmospherics/pipe/smart/manifold4w/cyan/visible,
/turf/open/floor/plating,
/area/station/engineering/supermatter/room)
"aO" = (
/obj/machinery/atmospherics/pipe/layer_manifold/orange/hidden{
	dir = 4
	},
/turf/open/floor/plating,
/area/station/engineering/supermatter/room)
"aR" = (
/obj/structure/sign/directions/ptl/directional/east,
/turf/open/floor/iron/dark,
/area/station/engineering/supermatter/room)
"aV" = (
/obj/effect/spawner/structure/window/reinforced/plasma,
/turf/open/floor/plating,
/area/station/engineering/supermatter/room)
"ba" = (
/obj/machinery/door/firedoor,
/obj/machinery/door/airlock/engineering/glass{
	name = "Space Engine Room"
	},
/obj/machinery/atmospherics/pipe/smart/manifold4w/supply/hidden/layer4,
/obj/machinery/atmospherics/pipe/smart/manifold4w/scrubbers/hidden/layer2,
/obj/effect/mapping_helpers/airlock/access/all/engineering/general,
/turf/open/floor/iron/dark,
/area/station/engineering/supermatter/room)
"bc" = (
/obj/machinery/atmospherics/pipe/smart/manifold4w/orange/visible,
/obj/effect/spawner/structure/window/reinforced/plasma,
/turf/open/floor/plating,
/area/station/engineering/supermatter/room)
"bj" = (
/obj/effect/turf_decal/stripes/line{
	dir = 1
	},
/obj/machinery/atmospherics/components/trinary/mixer/flipped{
	dir = 1
	},
/turf/open/floor/iron,
/area/station/engineering/supermatter/room)
"bP" = (
/obj/machinery/camera/emp_proof/directional/north{
	c_tag = "Singularity Engine #1"
	},
/turf/open/floor/iron/dark,
/area/station/engineering/supermatter/room)
"cb" = (
/turf/open/floor/plating,
/area/station/engineering/supermatter/room)
"cr" = (
/obj/item/sealant,
/turf/open/floor/plating,
/area/station/engineering/supermatter/room)
"cE" = (
/obj/machinery/atmospherics/components/trinary/mixer{
	dir = 1
	},
/obj/effect/turf_decal/stripes/line,
/turf/open/floor/iron,
/area/station/engineering/supermatter/room)
"cY" = (
/obj/machinery/atmospherics/components/unary/portables_connector/visible{
	dir = 4
	},
/obj/machinery/portable_atmospherics/canister/tritium,
/turf/open/floor/plating,
/area/station/engineering/supermatter/room)
"do" = (
/obj/effect/turf_decal/stripes/line,
/obj/effect/spawner/structure/window/reinforced/plasma,
/turf/open/floor/iron,
/area/station/engineering/supermatter/room)
"dp" = (
/obj/effect/turf_decal/stripes/line,
/obj/machinery/atmospherics/pipe/smart/manifold4w/supply/hidden/layer4,
/turf/open/floor/iron,
/area/station/engineering/supermatter/room)
"dR" = (
/obj/structure/sign/warning/secure_area,
/turf/closed/wall/r_wall,
/area/station/engineering/supermatter/room)
"dX" = (
/obj/machinery/atmospherics/components/unary/portables_connector/visible{
	dir = 8
	},
/obj/machinery/portable_atmospherics/canister/hydrogen,
/turf/open/floor/plating,
/area/station/engineering/supermatter/room)
"ek" = (
/obj/machinery/modular_computer/console/preset/engineering,
/turf/open/floor/plating,
/area/station/engineering/supermatter/room)
"eG" = (
/obj/machinery/atmospherics/components/unary/portables_connector/visible{
	dir = 8
	},
/obj/machinery/portable_atmospherics/canister/nitrogen,
/turf/open/floor/iron/dark,
/area/station/engineering/supermatter/room)
"fJ" = (
/obj/machinery/atmospherics/components/unary/portables_connector/visible{
	dir = 4
	},
/obj/machinery/portable_atmospherics/canister/water_vapor,
/turf/open/floor/plating,
/area/station/engineering/supermatter/room)
"ge" = (
/obj/machinery/atmospherics/components/unary/portables_connector/visible{
	dir = 4
	},
/obj/machinery/portable_atmospherics/canister/proto_nitrate,
/turf/open/floor/plating,
/area/station/engineering/supermatter/room)
"id" = (
/obj/machinery/door/airlock/engineering/glass{
	name = "PTL Room"
	},
/obj/effect/mapping_helpers/airlock/access/all/engineering/general,
/obj/structure/cable,
/turf/open/floor/iron/dark,
/area/station/engineering/supermatter/room)
"ik" = (
/obj/machinery/atmospherics/components/trinary/mixer,
/turf/open/floor/plating,
/area/station/engineering/supermatter/room)
"iX" = (
/obj/machinery/atmospherics/pipe/smart/manifold4w/orange/visible,
/obj/machinery/meter,
/turf/open/floor/plating,
/area/station/engineering/supermatter/room)
"ke" = (
/obj/machinery/door/firedoor,
/obj/machinery/door/airlock/engineering/glass{
	name = "Space Engine Room"
	},
/obj/effect/mapping_helpers/airlock/access/all/engineering/general,
/obj/structure/cable,
/turf/open/floor/iron/dark,
/area/station/engineering/supermatter/room)
"kl" = (
/obj/item/fuel_rod,
/turf/open/floor/plating,
/area/station/engineering/supermatter/room)
"lc" = (
/obj/machinery/light/directional/west,
/obj/machinery/atmospherics/components/unary/portables_connector/visible{
	dir = 4
	},
/obj/machinery/portable_atmospherics/canister/pluoxium,
/turf/open/floor/plating,
/area/station/engineering/supermatter/room)
"lM" = (
/obj/effect/turf_decal/stripes/line,
/obj/machinery/atmospherics/components/unary/portables_connector/visible{
	dir = 8
	},
/obj/machinery/portable_atmospherics/canister/nitrous_oxide,
/turf/open/floor/iron,
/area/station/engineering/supermatter/room)
"mD" = (
/obj/machinery/power/rad_collector,
/turf/open/floor/iron/dark,
/area/station/engineering/supermatter/room)
"nK" = (
/obj/machinery/atmospherics/components/unary/portables_connector/visible{
	dir = 8
	},
/obj/machinery/portable_atmospherics/canister/nitrium,
/turf/open/floor/plating,
/area/station/engineering/supermatter/room)
"nL" = (
/obj/machinery/camera/emp_proof/directional/east{
	c_tag = "Singularity Engine #3"
	},
/turf/open/floor/iron/dark,
/area/station/engineering/supermatter/room)
"oJ" = (
/obj/machinery/atmospherics/pipe/layer_manifold/green/hidden,
/turf/open/floor/plating,
/area/station/engineering/supermatter/room)
"pF" = (
/obj/machinery/atmospherics/components/unary/portables_connector/visible{
	dir = 8
	},
/obj/machinery/portable_atmospherics/canister/halon,
/turf/open/floor/plating,
/area/station/engineering/supermatter/room)
"pX" = (
/obj/structure/sign/warning/no_smoking,
/turf/closed/wall/r_wall,
/area/station/engineering/supermatter/room)
"qH" = (
/obj/effect/turf_decal/stripes/line,
/obj/machinery/atmospherics/components/unary/portables_connector/visible{
	dir = 4
	},
/obj/machinery/portable_atmospherics/canister/nob,
/turf/open/floor/iron,
/area/station/engineering/supermatter/room)
"qK" = (
/obj/machinery/atmospherics/components/binary/pump/reactor_moderator{
	dir = 4
	},
/turf/open/floor/plating,
/area/station/engineering/supermatter/room)
"rq" = (
/obj/item/fuel_rod/plutonium,
/turf/open/floor/plating,
/area/station/engineering/supermatter/room)
"rM" = (
/obj/machinery/power/apc/auto_name/directional/south,
/obj/structure/cable,
/turf/open/floor/iron/dark,
/area/station/engineering/supermatter/room)
"sf" = (
/obj/machinery/atmospherics/components/unary/portables_connector/visible{
	dir = 4
	},
/obj/machinery/portable_atmospherics/canister/plasma,
/turf/open/floor/plating,
/area/station/engineering/supermatter/room)
"sg" = (
/obj/machinery/atmospherics/components/unary/portables_connector/visible{
	dir = 8
	},
/obj/machinery/portable_atmospherics/canister/miasma,
/turf/open/floor/plating,
/area/station/engineering/supermatter/room)
"sP" = (
/obj/machinery/door/firedoor,
/obj/structure/cable,
/obj/machinery/door/airlock/engineering/glass{
	name = "Space Engine Room"
	},
/obj/effect/mapping_helpers/airlock/access/all/engineering/general,
/turf/open/floor/plating,
/area/station/engineering/supermatter/room)
"sW" = (
/obj/machinery/light/directional/west,
/turf/open/floor/iron/dark,
/area/station/engineering/supermatter/room)
"uG" = (
/obj/machinery/atmospherics/pipe/smart/manifold4w/green/visible,
/turf/open/floor/plating,
/area/station/engineering/supermatter/room)
"uI" = (
/obj/machinery/atmospherics/components/trinary/mixer{
	dir = 1
	},
/turf/open/floor/iron/dark,
/area/station/engineering/supermatter/room)
"vg" = (
/obj/machinery/atmospherics/pipe/heat_exchanging/simple{
	dir = 10
	},
/obj/structure/lattice/catwalk,
/turf/open/space/basic,
/area/space/nearstation)
"vm" = (
/obj/machinery/atmospherics/pipe/smart/manifold4w/cyan/visible,
/obj/machinery/meter,
/turf/open/floor/plating,
/area/station/engineering/supermatter/room)
"vw" = (
/obj/machinery/atmospherics/pipe/smart/manifold4w/orange/visible,
/turf/open/floor/plating,
/area/station/engineering/supermatter/room)
"wn" = (
/obj/effect/turf_decal/stripes/line{
	dir = 1
	},
/obj/machinery/atmospherics/components/unary/portables_connector/visible{
	dir = 8
	},
/obj/machinery/portable_atmospherics/canister/antinoblium,
/obj/structure/cable,
/turf/open/floor/iron/dark,
/area/station/engineering/supermatter/room)
"wT" = (
/obj/machinery/atmospherics/pipe/smart/manifold4w/green/visible,
/obj/machinery/light/directional/east,
/turf/open/floor/plating,
/area/station/engineering/supermatter/room)
"xe" = (
/obj/machinery/atmospherics/components/unary/portables_connector/visible{
	dir = 4
	},
/obj/machinery/portable_atmospherics/canister/oxygen,
/turf/open/floor/iron/dark,
/area/station/engineering/supermatter/room)
"xh" = (
/obj/machinery/atmospherics/components/trinary/filter/flipped/critical,
/obj/machinery/light/directional/east,
/turf/open/floor/plating,
/area/station/engineering/supermatter/room)
"xT" = (
/obj/structure/cable,
/obj/machinery/atmospherics/components/trinary/mixer/flipped{
	dir = 1
	},
/turf/open/floor/iron/dark,
/area/station/engineering/supermatter/room)
"yp" = (
/obj/machinery/door/firedoor,
/obj/machinery/door/airlock/engineering/glass{
	name = "Space Engine Room"
	},
/obj/effect/mapping_helpers/airlock/access/all/engineering/general,
/obj/structure/cable,
/turf/open/floor/plating,
/area/station/engineering/supermatter/room)
"zf" = (
/obj/structure/cable,
/obj/machinery/atmospherics/components/unary/portables_connector/visible{
	dir = 8
	},
/obj/machinery/portable_atmospherics/canister/bz,
/turf/open/floor/iron/dark,
/area/station/engineering/supermatter/room)
"zw" = (
/obj/machinery/atmospherics/pipe/heat_exchanging/simple{
	dir = 6
	},
/obj/structure/lattice/catwalk,
/turf/open/space/basic,
/area/space/nearstation)
"zR" = (
/obj/structure/cable,
/obj/machinery/door/airlock/engineering/glass{
	name = "Space Engine Room"
	},
/obj/effect/mapping_helpers/airlock/access/all/engineering/general,
/turf/open/floor/iron/dark,
/area/station/engineering/supermatter/room)
"AK" = (
/obj/machinery/atmospherics/pipe/heat_exchanging/simple,
/obj/structure/lattice/catwalk,
/turf/open/space/basic,
/area/space/nearstation)
"Bf" = (
/obj/effect/turf_decal/stripes/line{
	dir = 1
	},
/obj/effect/spawner/structure/window/reinforced/plasma,
/turf/open/floor/iron,
/area/station/engineering/supermatter/room)
"DN" = (
/obj/machinery/atmospherics/components/unary/portables_connector/visible{
	dir = 4
	},
/turf/open/floor/plating,
/area/station/engineering/supermatter/room)
"Ed" = (
/obj/machinery/atmospherics/pipe/smart/manifold4w/scrubbers/hidden/layer2,
/obj/structure/cable,
/turf/open/floor/iron/dark,
/area/station/engineering/supermatter/room)
"Eg" = (
/obj/machinery/atmospherics/components/unary/portables_connector/visible{
	dir = 8
	},
/obj/machinery/portable_atmospherics/canister/freon,
/turf/open/floor/plating,
/area/station/engineering/supermatter/room)
"Eq" = (
/obj/machinery/atmospherics/components/binary/pump/reactor_output{
	dir = 4
	},
/turf/open/floor/plating,
/area/station/engineering/supermatter/room)
"Fs" = (
/obj/machinery/atmospherics/components/trinary/mixer{
	dir = 1
	},
/turf/open/floor/plating,
/area/station/engineering/supermatter/room)
"Gz" = (
/obj/machinery/atmospherics/pipe/layer_manifold/cyan/hidden,
/turf/open/floor/plating,
/area/station/engineering/supermatter/room)
"GT" = (
/obj/machinery/atmospherics/components/binary/pump/reactor_input{
	dir = 8
	},
/turf/open/floor/plating,
/area/station/engineering/supermatter/room)
"HZ" = (
/obj/machinery/atmospherics/components/unary/thermomachine/freezer,
/turf/open/floor/plating,
/area/station/engineering/supermatter/room)
"Il" = (
/obj/machinery/atmospherics/components/unary/portables_connector/visible{
	dir = 8
	},
/obj/machinery/portable_atmospherics/canister/helium,
/turf/open/floor/plating,
/area/station/engineering/supermatter/room)
"IV" = (
/turf/template_noop,
/area/template_noop)
"Jq" = (
/obj/machinery/door/airlock/engineering/glass{
	name = "Space Engine Room"
	},
/obj/effect/mapping_helpers/airlock/access/all/engineering/general,
/obj/structure/cable,
/turf/open/floor/plating,
/area/station/engineering/supermatter/room)
"JL" = (
/obj/machinery/door/airlock/engineering/glass{
	name = "Space Engine Room"
	},
/obj/effect/mapping_helpers/airlock/access/all/engineering/general,
/turf/open/floor/plating,
/area/station/engineering/supermatter/room)
"Lz" = (
/obj/machinery/computer/reactor/main,
/turf/open/floor/plating,
/area/station/engineering/supermatter/room)
"LM" = (
/obj/effect/spawner/structure/window/reinforced/plasma,
/obj/machinery/atmospherics/components/trinary/mixer/flipped{
	dir = 1
	},
/turf/open/floor/plating,
/area/station/engineering/supermatter/room)
"LQ" = (
/obj/structure/lattice/catwalk,
/obj/machinery/atmospherics/components/unary/passive_vent{
	dir = 8
	},
/turf/open/space/basic,
/area/space/nearstation)
"MY" = (
/obj/machinery/atmospherics/pipe/smart/manifold4w/green/visible,
/obj/machinery/meter,
/turf/open/floor/plating,
/area/station/engineering/supermatter/room)
"Nk" = (
/obj/machinery/atmospherics/components/trinary/nuclear_reactor/engine{
	dir = 2
	},
/turf/open/floor/plating,
/area/station/engineering/supermatter/room)
"Np" = (
/obj/effect/turf_decal/stripes/line{
	dir = 1
	},
/turf/open/floor/iron,
/area/station/engineering/supermatter/room)
"OB" = (
/obj/machinery/atmospherics/pipe/heat_exchanging/simple{
	dir = 9
	},
/obj/structure/lattice/catwalk,
/turf/open/space/basic,
/area/space/nearstation)
"OD" = (
/obj/effect/turf_decal/stripes/line,
/turf/open/floor/iron,
/area/station/engineering/supermatter/room)
"Qe" = (
/obj/machinery/atmospherics/components/unary/portables_connector/visible{
	dir = 8
	},
/obj/machinery/portable_atmospherics/canister/carbon_dioxide,
/turf/open/floor/plating,
/area/station/engineering/supermatter/room)
"Qh" = (
/obj/effect/spawner/structure/window/reinforced/plasma,
/obj/machinery/atmospherics/pipe/smart/manifold4w/supply/hidden/layer4,
/turf/open/floor/plating,
/area/station/engineering/supermatter/room)
"QH" = (
/obj/structure/sign/delamination_counter/directional/north,
/turf/open/floor/iron/dark,
/area/station/engineering/supermatter/room)
"Ri" = (
/obj/machinery/atmospherics/components/unary/portables_connector/visible,
/obj/machinery/portable_atmospherics/canister/water_vapor,
/turf/open/floor/plating,
/area/station/engineering/supermatter/room)
"RQ" = (
/obj/machinery/atmospherics/components/unary/portables_connector/visible{
	dir = 4
	},
/obj/machinery/portable_atmospherics/canister/zauker,
/turf/open/floor/plating,
/area/station/engineering/supermatter/room)
"RX" = (
/obj/machinery/atmospherics/pipe/heat_exchanging/simple{
	dir = 4
	},
/obj/structure/lattice/catwalk,
/turf/open/space/basic,
/area/space/nearstation)
"TK" = (
/obj/machinery/light/directional/west,
/obj/machinery/airalarm/directional/south,
/obj/structure/cable,
/turf/open/floor/iron/dark,
/area/station/engineering/supermatter/room)
"Vl" = (
/obj/machinery/door/firedoor,
/obj/machinery/door/airlock/engineering/glass{
	name = "Supermatter Engine Room"
	},
/obj/effect/mapping_helpers/airlock/access/all/engineering/general,
/obj/machinery/atmospherics/pipe/smart/manifold4w/scrubbers/hidden/layer2,
/obj/structure/cable,
/turf/open/floor/plating,
/area/station/engineering/supermatter/room)
"VM" = (
/turf/open/floor/iron/dark,
/area/station/engineering/supermatter/room)
"Wd" = (
/obj/structure/cable,
/turf/open/floor/iron/dark,
/area/station/engineering/supermatter/room)
"XQ" = (
/obj/machinery/atmospherics/pipe/smart/manifold4w/green/visible,
/obj/item/fuel_rod/material/bananium,
/turf/open/floor/plating,
/area/station/engineering/supermatter/room)
"XV" = (
/obj/machinery/light/directional/west,
/obj/machinery/atmospherics/components/unary/portables_connector/visible{
	dir = 4
	},
/turf/open/floor/plating,
/area/station/engineering/supermatter/room)
"Ym" = (
/obj/machinery/atmospherics/pipe/heat_exchanging/simple{
	dir = 5
	},
/obj/structure/lattice/catwalk,
/turf/open/space/basic,
/area/space/nearstation)
"Yv" = (
/obj/machinery/atmospherics/components/trinary/mixer/flipped{
	dir = 1
	},
/turf/open/floor/plating,
/area/station/engineering/supermatter/room)
"YQ" = (
/obj/machinery/atmospherics/pipe/smart/manifold4w/scrubbers/hidden/layer2,
/obj/machinery/atmospherics/pipe/smart/manifold4w/supply/hidden/layer4,
/turf/open/floor/iron/dark,
/area/station/engineering/supermatter/room)
"Zv" = (
/obj/structure/cable,
/obj/machinery/power/rtg/debug,
/turf/open/floor/iron/dark,
/area/station/engineering/supermatter/room)

(1,1,1) = {"
IV
IV
IV
IV
au
aV
Vl
aV
dR
au
aV
sP
aV
pX
dR
aV
yp
Qh
au
IV
IV
IV
IV
IV
IV
"}
(2,1,1) = {"
IV
IV
IV
IV
au
Np
Ed
OD
au
sW
VM
Wd
Wd
TK
au
Np
Wd
dp
au
IV
IV
IV
IV
IV
IV
"}
(3,1,1) = {"
IV
IV
IV
IV
aV
Np
Wd
OD
JL
VM
VM
VM
VM
Wd
Jq
ax
Wd
OD
au
IV
IV
IV
IV
IV
IV
"}
(4,1,1) = {"
IV
IV
IV
IV
aV
Np
Wd
OD
au
QH
VM
VM
VM
Zv
au
Np
VM
OD
au
IV
IV
IV
IV
IV
IV
"}
(5,1,1) = {"
au
ba
au
aV
au
Np
Wd
OD
au
bP
VM
VM
VM
rM
au
Np
VM
OD
au
IV
IV
IV
IV
IV
IV
"}
(6,1,1) = {"
VM
YQ
sW
VM
au
aV
zR
aV
au
aV
LM
aV
aV
aV
au
Bf
am
do
au
IV
IV
IV
IV
IV
IV
"}
(7,1,1) = {"
VM
VM
mD
mD
aV
Np
Wd
DN
XV
RQ
fJ
cb
cY
ge
lc
sf
xe
qH
au
IV
IV
IV
IV
IV
IV
"}
(8,1,1) = {"
VM
VM
mD
mD
aV
Np
Wd
ik
ik
ik
ik
vw
ae
ae
ae
ae
ae
ae
cb
IV
IV
IV
IV
IV
IV
"}
(9,1,1) = {"
VM
VM
mD
mD
aV
bj
xT
Yv
Yv
Yv
Yv
iX
Fs
Fs
Fs
Fs
uI
cE
au
IV
IV
IV
IV
IV
IV
"}
(10,1,1) = {"
nL
aR
Wd
Wd
ke
wn
zf
Qe
Eg
pF
aI
qK
Il
dX
sg
nK
eG
lM
au
IV
IV
IV
IV
IV
IV
"}
(11,1,1) = {"
au
au
id
au
au
cb
cb
cb
cb
cb
cb
aO
cb
cb
cb
cb
cb
cb
aV
IV
IV
IV
IV
IV
IV
"}
(12,1,1) = {"
IV
IV
IV
IV
au
cb
cb
HZ
aJ
vm
Gz
Nk
oJ
MY
uG
ek
cb
cb
au
IV
IV
IV
IV
IV
IV
"}
(13,1,1) = {"
IV
IV
IV
IV
au
cr
cb
cb
GT
cb
cb
cb
cb
cb
Eq
Lz
cb
cb
au
IV
IV
IV
IV
IV
IV
"}
(14,1,1) = {"
IV
IV
IV
IV
au
cb
cb
Ri
aJ
cb
kl
kl
kl
HZ
uG
cb
cb
cb
au
IV
IV
IV
IV
IV
IV
"}
(15,1,1) = {"
IV
IV
IV
IV
au
cb
vw
vw
xh
uG
XQ
XQ
XQ
uG
wT
cb
cb
cb
au
IV
IV
IV
IV
IV
IV
"}
(16,1,1) = {"
IV
IV
IV
IV
au
cb
vw
cb
au
cb
rq
rq
rq
cb
au
cb
cb
cb
au
IV
IV
IV
IV
IV
IV
"}
(17,1,1) = {"
IV
IV
IV
IV
au
cb
vw
cb
cb
cb
cb
cb
cb
cb
cb
cb
cb
cb
au
IV
IV
IV
IV
IV
IV
"}
(18,1,1) = {"
IV
IV
IV
IV
au
aV
bc
aV
aV
aV
aV
aV
aV
aV
aV
aV
aV
aV
au
IV
IV
IV
IV
IV
IV
"}
(19,1,1) = {"
IV
IV
IV
IV
aa
aa
LQ
af
af
af
af
af
af
af
af
af
aa
aa
aa
IV
IV
IV
IV
IV
IV
"}
(20,1,1) = {"
IV
IV
IV
IV
aa
aa
aa
af
af
af
af
af
af
af
af
af
aa
aa
aa
IV
IV
IV
IV
IV
IV
"}
(21,1,1) = {"
IV
IV
IV
IV
aa
aa
aa
af
af
af
af
af
af
af
af
af
aa
aa
aa
IV
IV
IV
IV
IV
IV
"}
(22,1,1) = {"
IV
IV
IV
IV
aa
aa
aa
af
af
af
af
af
af
af
af
af
aa
aa
aa
IV
IV
IV
IV
IV
IV
"}
(23,1,1) = {"
IV
IV
IV
IV
aa
aa
aa
af
af
af
af
af
af
af
af
af
aa
aa
aa
IV
IV
IV
IV
IV
IV
"}
(24,1,1) = {"
IV
IV
IV
IV
aa
aa
aa
af
af
af
af
af
af
af
af
af
aa
aa
aa
IV
IV
IV
IV
IV
IV
"}
(25,1,1) = {"
IV
IV
IV
IV
aa
aa
aa
aa
aa
aa
aa
aa
aa
aa
aa
aa
aa
zw
Ym
IV
IV
IV
IV
IV
IV
"}
(26,1,1) = {"
IV
IV
IV
IV
aa
aa
aa
aa
aa
aa
aa
aa
aa
aa
aa
aa
aa
vg
OB
IV
IV
IV
IV
IV
IV
"}
(27,1,1) = {"
IV
IV
IV
IV
aa
aa
aa
aa
aa
aa
aa
aa
aa
aa
aa
aa
aa
RX
AK
IV
IV
IV
IV
IV
IV
"}
(28,1,1) = {"
IV
IV
IV
IV
aa
aa
aa
aa
aa
aa
aa
aa
aa
aa
aa
aa
aa
aa
aa
IV
IV
IV
IV
IV
IV
"}
(29,1,1) = {"
IV
IV
IV
IV
IV
IV
IV
IV
IV
IV
IV
IV
IV
IV
IV
IV
IV
IV
IV
IV
IV
IV
IV
IV
IV
"}
(30,1,1) = {"
IV
IV
IV
IV
IV
IV
IV
IV
IV
IV
IV
IV
IV
IV
IV
IV
IV
IV
IV
IV
IV
IV
IV
IV
IV
"}
(31,1,1) = {"
IV
IV
IV
IV
IV
IV
IV
IV
IV
IV
IV
IV
IV
IV
IV
IV
IV
IV
IV
IV
IV
IV
IV
IV
IV
"}
(32,1,1) = {"
IV
IV
IV
IV
IV
IV
IV
IV
IV
IV
IV
IV
IV
IV
IV
IV
IV
IV
IV
IV
IV
IV
IV
IV
IV
"}
(33,1,1) = {"
IV
IV
IV
IV
IV
IV
IV
IV
IV
IV
IV
IV
IV
IV
IV
IV
IV
IV
IV
IV
IV
IV
IV
IV
IV
"}
